EmptyHover=без полза
HeadLightsHover=Превключване фарове
FloodLightsHover=Превключване прожектори
NavLightsHover=Превключване навигационни светлини
InteriorLightsHover=Превключване вътрешно осветление
DefaultColorHover=Възстанови оригинални цветове
PowerHover=Превключване захранване
AutoPilotHover=Отвори Авто-пилот (за изпълнение)
OpenStorage=Отвори съхранение
VehicleBattery=Батерия на превозно средство
AutoPilotBattery=Батерия на Авто-пилота
EnterVehicle=Влезте в превозното средство
ExitVehicle=Излезте от превозното средство
Vehicle=Превозно средство
StartPiloting=Започнете управление
TooSteep=Ъгълът е твърде стръмен.\nЗа нивелиране, двойно докосване 
TooFast=Скоростта е твърде голяма.\nЗа забавяне, двойно докосване 
Depth1FriendlyString=Модул дълбочина на превозно средство MK1
Depth1Description=Увеличава дълбочината малко. Не се натрупва.
Depth2FriendlyString=Модул дълбочина на превозно средство MK2
Depth2Description=Увеличава дълбочината умерено. Не се натрупва.
Depth3FriendlyString=Модул дълбочина на превозно средство MK3
Depth3Description=Увеличава дълбочината значително. Не се натрупва.
MainExterior=Основен екстериор
PrimaryAccent=Акцент 1
SecondaryAccent=Акцент 2
NameLabel=Етикет с име
MVModules=VF Ъпгрейди за превозни средства
MVDepthModules=Модули за дълбочина
SpecificModules=Специфични надстройки за превозни средства
GeneralTab=Общи
SeamothTab=Подобрения за Seamoth
PrawnTab=Подобрения за Prawn Suit
CyclopsTab=Подобрения за Cyclops