EmptyHover=bez užitku
HeadLightsHover=Přepnout světlomety
FloodLightsHover=Přepnout reflektory
NavLightsHover=Přepnout navigační světla
InteriorLightsHover=Přepnout vnitřní osvětlení
DefaultColorHover=Obnovit výchozí barvy
PowerHover=Přepnout napájení
AutoPilotHover=Otevřít Auto-Pilota (k udělání)
OpenStorage=Otevřít úložiště
VehicleBattery=Baterie vozidla
AutoPilotBattery=Baterie Auto-Pilota
EnterVehicle=Nastoupit do vozidla
ExitVehicle=Vystoupit z vozidla
Vehicle=Vozidlo
StartPiloting=Začít pilotování
TooSteep=Úhel je příliš strmý.\nPro vyrovnání, dvojklik 
TooFast=Rychlost je příliš velká.\nPro brzdění, dvojklik 
Depth1FriendlyString=Modul hloubky vozidla MK1
Depth1Description=Zvýší tlakovou hloubku mírně. Nekumuluje.
Depth2FriendlyString=Modul hloubky vozidla MK2
Depth2Description=Zvýší tlakovou hloubku středně. Nekumuluje.
Depth3FriendlyString=Modul hloubky vozidla MK3
Depth3Description=Zvýší tlakovou hloubku výrazně. Nekumuluje.
MainExterior=Hlavní exteriér
PrimaryAccent=Accent 1
SecondaryAccent=Accent 2
NameLabel=Jmenovka
MVModules=VF Vylepšení vozidel
MVDepthModules=Moduly hloubky
SpecificModules=Specifická vylepšení vozidel
GeneralTab=Obecné
SeamothTab=Vylepšení pro Seamoth
PrawnTab=Vylepšení pro Prawn Suit
CyclopsTab=Vylepšení pro Cyclops