EmptyHover=uden nytte
HeadLightsHover=Skift forlygter
FloodLightsHover=Skift projektører
NavLightsHover=Skift navigationslys
InteriorLightsHover=Skift kabinebelysning
DefaultColorHover=Nulstil standardfarver
PowerHover=Skift strøm
AutoPilotHover=Åbn Auto-Pilot (to do)
OpenStorage=Åbn opbevaring
VehicleBattery=Køretøjsbatteri
AutoPilotBattery=Auto-Pilot batteri
EnterVehicle=Enter køretøj
ExitVehicle=Forlad køretøj
Vehicle=Køretøj
StartPiloting=Start styring
TooSteep=Vinklen er for stejl.\nFor at nivellere, dobbeltklik 
TooFast=Farten er for høj.\nFor at bremse, dobbeltklik 
Depth1FriendlyString=Køretøjsdybde Modul MK1
Depth1Description=Øger knusningsdybde lidt. Kan ikke stables.
Depth2FriendlyString=Køretøjsdybde Modul MK2
Depth2Description=Øger knusningsdybde moderat. Kan ikke stables.
Depth3FriendlyString=Køretøjsdybde Modul MK3
Depth3Description=Øger knusningsdybde betydeligt. Kan ikke stables.
MainExterior=Hovedeksteriør
PrimaryAccent=Accent 1
SecondaryAccent=Accent 2
NameLabel=Navneetiket
MVModules=VF Køretøjsopgraderinger
MVDepthModules=Dybde moduler
SpecificModules=Specifikke køretøjsopgraderinger
GeneralTab=Generelt
SeamothTab=Seamoth-opgraderinger
PrawnTab=Prawn Suit-opgraderinger
CyclopsTab=Cyclops-opgraderinger