EmptyHover=nutzlos
HeadLightsHover=Scheinwerfer umschalten
FloodLightsHover=Flutlicht umschalten
NavLightsHover=Navigationslichter umschalten
InteriorLightsHover=Innenbeleuchtung umschalten
DefaultColorHover=Standardfarben zurücksetzen
PowerHover=Stromversorgung umschalten
AutoPilotHover=Autopilot öffnen (to do)
OpenStorage=Stauraum öffnen
VehicleBattery=Fahrzeugbatterie
AutoPilotBattery=Autopilot-Batterie
EnterVehicle=Fahrzeug betreten
ExitVehicle=Fahrzeug verlassen
Vehicle=Fahrzeug
StartPiloting=Pilotierung starten
TooSteep=Winkel zu steil.\nZum Ausgleich, doppelklick 
TooFast=Geschwindigkeit zu hoch.\nZum Bremsen, doppelklick 
Depth1FriendlyString=Fahrzeug-Tiefenmodul MK1
Depth1Description=Erhöht Drucktiefe geringfügig. Nicht stapelbar.
Depth2FriendlyString=Fahrzeug-Tiefenmodul MK2
Depth2Description=Erhöht Drucktiefe mäßig. Nicht stapelbar.
Depth3FriendlyString=Fahrzeug-Tiefenmodul MK3
Depth3Description=Erhöht Drucktiefe stark. Nicht stapelbar.
MainExterior=Hauptäußeres
PrimaryAccent=Akzent 1
SecondaryAccent=Akzent 2
NameLabel=Namensschild
MVModules=VF-Fahrzeugaufrüstungen
MVDepthModules=Tiefenmodule
SpecificModules=Fahrzeugspezifische Upgrades
GeneralTab=Allgemein
SeamothTab=Seamoth-Upgrades
PrawnTab=Prawn Suit-Upgrades
CyclopsTab=Cyclops-Upgrades