EmptyHover=χωρίς χρήση
HeadLightsHover=Εναλλαγή Φώτων Κεφαλής
FloodLightsHover=Εναλλαγή Προβολέων
NavLightsHover=Εναλλαγή Φώτων Πλοήγησης
InteriorLightsHover=Εναλλαγή Εσωτερικού Φωτισμού
DefaultColorHover=Επαναφορά Προεπιλεγμένων Χρωμάτων
PowerHover=Εναλλαγή Ρεύματος
AutoPilotHover=Άνοιγμα Αυτόματου Πιλότου (υπό κατασκευή)
OpenStorage=Άνοιγμα Αποθηκευτικού Χώρου
VehicleBattery=Μπαταρία Οχήματος
AutoPilotBattery=Μπαταρία Αυτόματου Πιλότου
EnterVehicle=Είσοδος Οχήματος
ExitVehicle=Έξοδος Οχήματος
Vehicle=Όχημα
StartPiloting=Έναρξη Πιλότου
TooSteep=Η γωνία είναι πολύ απότομη.\nΓια αυτόματη ισορροπία, πατήστε δύο φορές 
TooFast=Η ταχύτητα είναι πολύ υψηλή.\nΓια αυτόματο φρενάρισμα, πατήστε δύο φορές 
Depth1FriendlyString=Μονάδα Βάθους Οχήματος MK1
Depth1Description=Αυξάνει το Όριο Πίεσης ελαφρώς. Δεν συσσωρεύεται.
Depth2FriendlyString=Μονάδα Βάθους Οχήματος MK2
Depth2Description=Αυξάνει το Όριο Πίεσης μέτρια. Δεν συσσωρεύεται.
Depth3FriendlyString=Μονάδα Βάθους Οχήματος MK3
Depth3Description=Αυξάνει το Όριο Πίεσης σημαντικά. Δεν συσσωρεύεται.
MainExterior=Κύριο Εξωτερικό
PrimaryAccent=Δευτερεύον Χρώμα 1
SecondaryAccent=Δευτερεύον Χρώμα 2
NameLabel=Ετικέτα Ονόματος
MVModules=VF Αναβαθμίσεις Οχημάτων
MVDepthModules=Μονάδες βάθους
SpecificModules=Ειδικές αναβαθμίσεις οχημάτων
GeneralTab=Γενικά
SeamothTab=Αναβαθμίσεις Seamoth
PrawnTab=Αναβαθμίσεις Prawn Suit
CyclopsTab=Αναβαθμίσεις Cyclops