EmptyHover=of no use
HeadLightsHover=Toggle Headlights
FloodLightsHover=Toggle Flood Lights
NavLightsHover=Toggle Nav Lights
InteriorLightsHover=Toggle Interior Lighting
DefaultColorHover=Revert to Default Colors
PowerHover=Toggle Power
AutoPilotHover=Open Auto-Pilot (to do)
OpenStorage=Open Storage
VehicleBattery=Vehicle Battery
AutoPilotBattery=Auto-Pilot Battery
EnterVehicle=Enter Vehicle
ExitVehicle=Exit Vehicle
Vehicle=Vehicle
StartPiloting=Start Piloting
TooSteep=Angle is too steep.\nTo auto-level, double tap 
TooFast=Velocity is too great.\nTo auto-brake, double tap 
Depth1FriendlyString=Vehicle Depth Module MK1
Depth1Description=Increases Crush Depth Marginally. Does Not Stack.
Depth2FriendlyString=Vehicle Depth Module MK2
Depth2Description=Increases Crush Depth Moderately. Does Not Stack.
Depth3FriendlyString=Vehicle Depth Module MK3
Depth3Description=Increases Crush Depth Greatly. Does Not Stack.
MainExterior=Main Exterior
PrimaryAccent=Accent 1
SecondaryAccent=Accent 2
NameLabel=Name Label
MVModules=VF Vehicle Upgrades
MVDepthModules=Depth Modules
SpecificModules=Specific Vehicle Upgrades
GeneralTab=General
SeamothTab=Seamoth Upgrades
PrawnTab=Prawn Upgrades
CyclopsTab=Cyclops Upgrades
