EmptyHover=inútil
HeadLightsHover=Cambiar faros
FloodLightsHover=Cambiar luces antiniebla
NavLightsHover=Cambiar luces de navegación
InteriorLightsHover=Cambiar luces interiores
DefaultColorHover=Restablecer colores predet.
PowerHover=Cambiar energía
AutoPilotHover=Abrir Auto-Piloto (por hacer)
OpenStorage=Abrir almacenamiento
VehicleBattery=Batería del vehículo
AutoPilotBattery=Batería del Auto-Piloto
EnterVehicle=Entrar al vehículo
ExitVehicle=Salir del vehículo
Vehicle=Vehículo
StartPiloting=Iniciar pilotaje
TooSteep=Ángulo demasiado inclinado.\nPara nivelar, toque dos veces 
TooFast=Velocidad demasiado alta.\nPara frenar, toque dos veces 
Depth1FriendlyString=Módulo de Profundidad MK1
Depth1Description=Aumenta límite de profundidad ligeramente. No acumulable.
Depth2FriendlyString=Módulo de Profundidad MK2
Depth2Description=Aumenta límite de profundidad moderadamente. No acumulable.
Depth3FriendlyString=Módulo de Profundidad MK3
Depth3Description=Aumenta límite de profundidad considerablemente. No acumulable.
MainExterior=Exterior principal
PrimaryAccent=Acento 1
SecondaryAccent=Acento 2
NameLabel=Etiqueta de nombre
MVModules=Mejoras de Vehículos VF
MVDepthModules=Módulos de Profundidad
SpecificModules=Mejoras Específicas de Vehículos
GeneralTab=General
SeamothTab=Mejoras de Seamoth
PrawnTab=Mejoras de Prawn Suit
CyclopsTab=Mejoras de Cyclops