EmptyHover=kasutu
HeadLightsHover=Lülita esituled
FloodLightsHover=Lülita prožektorid
NavLightsHover=Lülita navigatsioonituled
InteriorLightsHover=Lülita salongi valgustus
DefaultColorHover=Taasta vaikevärvid
PowerHover=Lülita toide
AutoPilotHover=Ava autopiloot (tegemisel)
OpenStorage=Ava hoiuruum
VehicleBattery=Sõiduki aku
AutoPilotBattery=Autopiloodi aku
EnterVehicle=Sisene sõidukisse
ExitVehicle=Välju sõidukist
Vehicle=Sõiduk
StartPiloting=Alusta juhtimist
TooSteep=Nurk on liiga järsk.\nAutomaatseks tasandamiseks topeltkoputage 
TooFast=Kiirus on liiga suur.\nAutomaatseks pidurdamiseks topeltkoputage 
Depth1FriendlyString=Sõiduki sügavusmoodul MK1
Depth1Description=Suurendab purustussügavust veidi. Ei kuhju.
Depth2FriendlyString=Sõiduki sügavusmoodul MK2
Depth2Description=Suurendab purustussügavust mõõdukalt. Ei kuhju.
Depth3FriendlyString=Sõiduki sügavusmoodul MK3
Depth3Description=Suurendab purustussügavust oluliselt. Ei kuhju.
MainExterior=Põhiväline
PrimaryAccent=Aktsent 1
SecondaryAccent=Aktsent 2
NameLabel=Nimisilt
MVModules=VF Sõidukite täiustused
MVDepthModules=Sügavusmoodulid
SpecificModules=Spetsiifilised sõiduki täiendused
GeneralTab=Üldine
SeamothTab=Seamothi täiendused
PrawnTab=Prawn Suiti täiendused
CyclopsTab=Cyclopsi täiendused