EmptyHover=hyödytön
HeadLightsHover=Vaihda ajovalot
FloodLightsHover=Vaihda työvalot
NavLightsHover=Vaihda navigointivalot
InteriorLightsHover=Vaihda sisävalaistus
DefaultColorHover=Palauta oletusvärit
PowerHover=Vaihda virta
AutoPilotHover=Avaa autopilotti (tehtävä)
OpenStorage=Avaa säilytystila
VehicleBattery=Ajoneuvon akku
AutoPilotBattery=Autopilotin akku
EnterVehicle=Astu ajoneuvoon
ExitVehicle=Poistu ajoneuvosta
Vehicle=Ajoneuvo
StartPiloting=Aloita ohjaus
TooSteep=Kulma on liian jyrkkä.\nAutomaattiseen tasaukseen, kaksoisnapauta 
TooFast=Nopeus on liian suuri.\nAutomaattiseen jarrutukseen, kaksoisnapauta 
Depth1FriendlyString=Ajoneuvon syvyysmoduuli MK1
Depth1Description=Lisää murskaussyvyyttä hieman. Ei kumuloidu.
Depth2FriendlyString=Ajoneuvon syvyysmoduuli MK2
Depth2Description=Lisää murskaussyvyyttä kohtalaisesti. Ei kumuloidu.
Depth3FriendlyString=Ajoneuvon syvyysmoduuli MK3
Depth3Description=Lisää murskaussyvyyttä huomattavasti. Ei kumuloidu.
MainExterior=Pääulkopinta
PrimaryAccent=Korostusväri 1
SecondaryAccent=Korostusväri 2
NameLabel=Nimilappu
MVModules=VF Ajoneuvopäivitykset
MVDepthModules=Syvyysmoduulit
SpecificModules=Ajoneuvokohtaiset päivitykset
GeneralTab=Yleinen
SeamothTab=Seamoth-päivitykset
PrawnTab=Prawn Suit -päivitykset
CyclopsTab=Cyclops-päivitykset