EmptyHover=inutile
HeadLightsHover=Phares à bascule
FloodLightsHover=Feux de travail à bascule
NavLightsHover=Lumières de navigation à bascule
InteriorLightsHover=Lumières intérieures à bascule
DefaultColorHover=Rétablir les couleurs par défaut
PowerHover=Bascule de l'alimentation
AutoPilotHover=Ouvrir l'Auto-Pilote (à faire)
OpenStorage=Ouvrir le stockage
VehicleBattery=Batterie du véhicule
AutoPilotBattery=Batterie de l'Auto-Pilote
EnterVehicle=Entrer dans le véhicule
ExitVehicle=Sortir du véhicule
Vehicle=Véhicule
StartPiloting=Commencer à piloter
TooSteep=Angle trop raide.\nPour un nivellement automatique, double-tapez 
TooFast=Vitesse trop élevée.\nPour un freinage automatique, double-tapez 
Depth1FriendlyString=Module de profondeur du véhicule MK1
Depth1Description=Augmente légèrement la profondeur d'écrasement. Ne s'accumule pas.
Depth2FriendlyString=Module de profondeur du véhicule MK2
Depth2Description=Augmente modérément la profondeur d'écrasement. Ne s'accumule pas.
Depth3FriendlyString=Module de profondeur du véhicule MK3
Depth3Description=Augmente considérablement la profondeur d'écrasement. Ne s'accumule pas.
MainExterior=Extérieur principal
PrimaryAccent=Accent 1
SecondaryAccent=Accent 2
NameLabel=Étiquette de nom
MVModules=Améliorations de véhicules VF
MVDepthModules=Modules de profondeur
SpecificModules=Mises à niveau spécifiques aux véhicules
GeneralTab=Général
SeamothTab=Mises à niveau du Seamoth
PrawnTab=Mises à niveau du Prawn Suit
CyclopsTab=Mises à niveau du Cyclops