EmptyHover=gan úsáid
HeadLightsHover=Scor solais cinn
FloodLightsHover=Scor solais tuilte
NavLightsHover=Scor solais loingseoireachta
InteriorLightsHover=Scor solais inmheánach
DefaultColorHover=Athshocrú dathanna réamhshocraithe
PowerHover=Scor cumhachta
AutoPilotHover=Oscail Auto-Píolóta (le déanamh)
OpenStorage=Oscail stóras
VehicleBattery=Baictéar feithicle
AutoPilotBattery=Baictéar Auto-Píolóta
EnterVehicle=Teacht isteach sa fheithicil
ExitVehicle=Fág an fheithicil
Vehicle=Feithicil
StartPiloting=Tosaigh ag píolótáil
TooSteep=Uillinn ró-gharbh.\nLe haghaidh uasdátú uathoibríoch, dúbailbheartaigh 
TooFast=Luas ró-mhór.\nLe haghaidh cosc uathoibríoch, dúbailbheartaigh 
Depth1FriendlyString=Modúl doimhneachta feithicle MK1
Depth1Description=Méadóidh sé doimhneacht comraic go beagán. Ní bhaineann sé le chéile.
Depth2FriendlyString=Modúl doimhneachta feithicle MK2
Depth2Description=Méadóidh sé doimhneacht comraic go measartha. Ní bhaineann sé le chéile.
Depth3FriendlyString=Modúl doimhneachta feithicle MK3
Depth3Description=Méadóidh sé doimhneacht comraic go mór. Ní bhaineann sé le chéile.
MainExterior=Príomhlasmuigh
PrimaryAccent=Aiceann 1
SecondaryAccent=Aiceann 2
NameLabel=Lipéad ainm
MVModules=Uasghrádúcháin Feithicle VF
MVDepthModules=Modúil Doimhneachta
SpecificModules=Uasghráduithe Sonracha Feithiclí
GeneralTab=Ginearálta
SeamothTab=Uasghráduithe Seamoth
PrawnTab=Uasghráduithe Prawn Suit
CyclopsTab=Uasghráduithe Cyclops