EmptyHover=beskoristan
HeadLightsHover=Prekidač farova
FloodLightsHover=Prekidač reflektora
NavLightsHover=Prekidač navigacijskih svjetala
InteriorLightsHover=Prekidač unutarnjeg osvjetljenja
DefaultColorHover=Povratak na zadane boje
PowerHover=Prekidač napajanja
AutoPilotHover=Otvori Auto-Pilota (za napraviti)
OpenStorage=Otvori spremište
VehicleBattery=Baterija vozila
AutoPilotBattery=Baterija Auto-Pilota
EnterVehicle=Uđi u vozilo
ExitVehicle=Izađi iz vozila
Vehicle=Vozilo
StartPiloting=Započni pilotiranje
TooSteep=Kut je prevelik.\nZa automatsko izravnavanje, dvostruki dodir 
TooFast=Brzina je prevelika.\nZa automatsko kočenje, dvostruki dodir 
Depth1FriendlyString=Modul dubine vozila MK1
Depth1Description=Umjereno povećava dubinu drobljenja. Ne akumulira se.
Depth2FriendlyString=Modul dubine vozila MK2
Depth2Description=Umjereno povećava dubinu drobljenja. Ne akumulira se.
Depth3FriendlyString=Modul dubine vozila MK3
Depth3Description=Značajno povećava dubinu drobljenja. Ne akumulira se.
MainExterior=Glavni eksterijer
PrimaryAccent=Akcent 1
SecondaryAccent=Akcent 2
NameLabel=Oznaka imena
MVModules=VF Nadogradnje vozila
MVDepthModules=Moduli dubine
SpecificModules=Specifične nadogradnje vozila
GeneralTab=Opće
SeamothTab=Nadogradnje za Seamoth
PrawnTab=Nadogradnje za Prawn Suit
CyclopsTab=Nadogradnje za Cyclops