EmptyHover=haszontalan
HeadLightsHover=Fényszórók kapcsolása
FloodLightsHover=Reflektorok kapcsolása
NavLightsHover=Navigációs fények kapcsolása
InteriorLightsHover=Belső világítás kapcsolása
DefaultColorHover=Visszaállítás az alapértelmezett színekre
PowerHover=Áramkapcsoló
AutoPilotHover=Nyissa meg az Auto-Pilótát (teendő)
OpenStorage=Tároló megnyitása
VehicleBattery=Jármű akkumulátor
AutoPilotBattery=Auto-Pilót akkumulátor
EnterVehicle=Beszállás a járműbe
ExitVehicle=Kiszállás a járműből
Vehicle=Jármű
StartPiloting=Irányítás megkezdése
TooSteep=Túl meredek szög.\nAutomatikus kiegyenlítéshez dupla koppintás 
TooFast=Túl gyors sebesség.\nAutomatikus fékezéshez dupla koppintás 
Depth1FriendlyString=Jármű Mélység Modul MK1
Depth1Description=Nyomásmélység enyhe növelése. Nem halmozódik.
Depth2FriendlyString=Jármű Mélység Modul MK2
Depth2Description=Nyomásmélység közepes növelése. Nem halmozódik.
Depth3FriendlyString=Jármű Mélység Modul MK3
Depth3Description=Nyomásmélység jelentős növelése. Nem halmozódik.
MainExterior=Fő külső
PrimaryAccent=Hangsúly 1
SecondaryAccent=Hangsúly 2
NameLabel=Névcímke
MVModules=VF Járműfejlesztések
MVDepthModules=Mélységmodulok
SpecificModules=Járműspecifikus fejlesztések
GeneralTab=Általános
SeamothTab=Seamoth fejlesztések
PrawnTab=Prawn Suit fejlesztések
CyclopsTab=Cyclops fejlesztések