EmptyHover=inutile
HeadLightsHover=Interruttore fari
FloodLightsHover=Interruttore fari supplementari
NavLightsHover=Interruttore luci di navigazione
InteriorLightsHover=Interruttore luci interne
DefaultColorHover=Ripristina colori predefiniti
PowerHover=Interruttore alimentazione
AutoPilotHover=Apri Auto-Pilota (da fare)
OpenStorage=Apri deposito
VehicleBattery=Batteria veicolo
AutoPilotBattery=Batteria Auto-Pilota
EnterVehicle=Entrare nel veicolo
ExitVehicle=Uscire dal veicolo
Vehicle=Veicolo
StartPiloting=Inizia a pilotare
TooSteep=Angolo troppo ripido.\nPer livellare automaticamente, doppio tocco 
TooFast=Velocità troppo elevata.\nPer frenare automaticamente, doppio tocco 
Depth1FriendlyString=Modulo profondità veicolo MK1
Depth1Description=Aumenta leggermente la profondità di schiacciamento. Non cumulabile.
Depth2FriendlyString=Modulo profondità veicolo MK2
Depth2Description=Aumenta moderatamente la profondità di schiacciamento. Non cumulabile.
Depth3FriendlyString=Modulo profondità veicolo MK3
Depth3Description=Aumenta notevolmente la profondità di schiacciamento. Non cumulabile.
MainExterior=Esterno principale
PrimaryAccent=Accento 1
SecondaryAccent=Accento 2
NameLabel=Etichetta nome
MVModules=Aggiornamenti Veicoli VF
MVDepthModules=Moduli di profondità
SpecificModules=Aggiornamenti specifici per veicoli
GeneralTab=Generale
SeamothTab=Aggiornamenti Seamoth
PrawnTab=Aggiornamenti Prawn Suit
CyclopsTab=Aggiornamenti Cyclops