EmptyHover=無用
HeadLightsHover=ヘッドライトの切替
FloodLightsHover=投光器の切替
NavLightsHover=ナビゲーションライトの切替
InteriorLightsHover=室内照明の切替
DefaultColorHover=デフォルトの色に戻す
PowerHover=電源の切替
AutoPilotHover=オートパイロットを開く（やること）
OpenStorage=ストレージを開く
VehicleBattery=車両用バッテリー
AutoPilotBattery=オートパイロット用バッテリー
EnterVehicle=車両に入る
ExitVehicle=車両から出る
Vehicle=車両
StartPiloting=操縦開始
TooSteep=角度が急すぎます。\n自動水平調整のためにダブルタップ 
TooFast=速度が速すぎます。\n自動ブレーキのためにダブルタップ 
Depth1FriendlyString=車両深度モジュールMK1
Depth1Description=圧縮深度がわずかに増加。スタックしません。
Depth2FriendlyString=車両深度モジュールMK2
Depth2Description=圧縮深度が適度に増加。スタックしません。
Depth3FriendlyString=車両深度モジュールMK3
Depth3Description=圧縮深度が大幅に増加。スタックしません。
MainExterior=メイン外装
PrimaryAccent=アクセント1
SecondaryAccent=アクセント2
NameLabel=名前ラベル
MVModules=VF ビークルアップグレード
MVDepthModules=深度モジュール
SpecificModules=特定の乗り物アップグレード
GeneralTab=一般
SeamothTab=Seamothアップグレード
PrawnTab=Prawn Suitアップグレード
CyclopsTab=Cyclopsアップグレード