EmptyHover=쓸모 없음
HeadLightsHover=헤드라이트 전환
FloodLightsHover=홍수 조명 전환
NavLightsHover=항로 조명 전환
InteriorLightsHover=실내 조명 전환
DefaultColorHover=기본 색상으로 되돌리기
PowerHover=전원 전환
AutoPilotHover=오토 파일럿 열기(할 일)
OpenStorage=저장소 열기
VehicleBattery=차량 배터리
AutoPilotBattery=오토 파일럿 배터리
EnterVehicle=차량 들어가기
ExitVehicle=차량 나가기
Vehicle=차량
StartPiloting=조종 시작
TooSteep=각도가 너무 가파름.\n자동 수평 조절을 위해 두 번 탭하세요 
TooFast=속도가 너무 빠름.\n자동 제동을 위해 두 번 탭하세요 
Depth1FriendlyString=차량 심도 모듈 MK1
Depth1Description=압축 깊이를 약간 증가시킵니다. 중첩되지 않습니다.
Depth2FriendlyString=차량 심도 모듈 MK2
Depth2Description=압축 깊이를 적당히 증가시킵니다. 중첩되지 않습니다.
Depth3FriendlyString=차량 심도 모듈 MK3
Depth3Description=압축 깊이를 크게 증가시킵니다. 중첩되지 않습니다.
MainExterior=주 외관
PrimaryAccent=악센트 1
SecondaryAccent=악센트 2
NameLabel=이름 라벨
MVModules=VF 차량 업그레이드
MVDepthModules=심도 모듈
SpecificModules=특정 차량 업그레이드
GeneralTab=일반
SeamothTab=Seamoth 업그레이드
PrawnTab=Prawn Suit 업그레이드
CyclopsTab=Cyclops 업그레이드