EmptyHover=be naudos
HeadLightsHover=Perjungti priekinius žibintus
FloodLightsHover=Perjungti prožektoriaus žibintus
NavLightsHover=Perjungti navigacijos šviesas
InteriorLightsHover=Perjungti vidaus apšvietimą
DefaultColorHover=Grąžinti numatytąsias spalvas
PowerHover=Perjungti energiją
AutoPilotHover=Atidaryti Auto-Pilotą (darbotvarkėje)
OpenStorage=Atidaryti saugyklą
VehicleBattery=Transporto priemonės baterija
AutoPilotBattery=Auto-Piloto baterija
EnterVehicle=Įlipti į transporto priemonę
ExitVehicle=Išlipti iš transporto priemonės
Vehicle=Transporto priemonė
StartPiloting=Pradėti vairavimą
TooSteep=Kampas per didelis.\nKad automatiškai išlygintumėte, dukart spustelėkite 
TooFast=Greitis per didelis.\nKad automatiškai stabdytumėte, dukart spustelėkite 
Depth1FriendlyString=Transporto priemonės gilumo modulis MK1
Depth1Description=Nedidelis slėgio gilumos padidėjimas. Nesikaupia.
Depth2FriendlyString=Transporto priemonės gilumo modulis MK2
Depth2Description=Vidutinio slėgio gilumos padidėjimas. Nesikaupia.
Depth3FriendlyString=Transporto priemonės gilumo modulis MK3
Depth3Description=Didelis slėgio gilumos padidėjimas. Nesikaupia.
MainExterior=Pagrindinis išorinis
PrimaryAccent=Akcentas 1
SecondaryAccent=Akcentas 2
NameLabel=Pavadinimo etiketė
MVModules=VF Transporto priemonių patobulinimai
MVDepthModules=Gylio moduliai
SpecificModules=Specifiniai transporto priemonių patobulinimai
GeneralTab=Bendra
SeamothTab=Seamoth patobulinimai
PrawnTab=Prawn Suit patobulinimai
CyclopsTab=Cyclops patobulinimai