EmptyHover=bez jēgas
HeadLightsHover=Pārslēgt priekšējās gaismas
FloodLightsHover=Pārslēgt plūdu gaismas
NavLightsHover=Pārslēgt navigācijas gaismas
InteriorLightsHover=Pārslēgt iekštelpu apgaismojumu
DefaultColorHover=Atgriezties pie noklusējuma krāsām
PowerHover=Pārslēgt enerģiju
AutoPilotHover=Atvērt Auto-Pilota (darāmās lietas)
OpenStorage=Atvērt krātuvi
VehicleBattery=Transportlīdzekļa akumulators
AutoPilotBattery=Auto-Pilota akumulators
EnterVehicle=Iekāpt transportlīdzeklī
ExitVehicle=Izkāpt no transportlīdzekļa
Vehicle=Transportlīdzeklis
StartPiloting=Sākt vadību
TooSteep=Leņķis ir pārāk liels.\nLai automātiski izlīdzinātu, dubultklikšķis 
TooFast=Ātrums ir pārāk liels.\nLai automātiski bremzētu, dubultklikšķis 
Depth1FriendlyString=Transportlīdzekļa dziluma modulis MK1
Depth1Description=Nedaudz palielina saspiešanas dziļumu. Nekrājas.
Depth2FriendlyString=Transportlīdzekļa dziluma modulis MK2
Depth2Description=Mēreni palielina saspiešanas dziļumu. Nekrājas.
Depth3FriendlyString=Transportlīdzekļa dziluma modulis MK3
Depth3Description=Ievērojami palielina saspiešanas dziļumu. Nekrājas.
MainExterior=Galvenā ārpuse
PrimaryAccent=Akcents 1
SecondaryAccent=Akcents 2
NameLabel=Nosaukuma etiķete
MVModules=VF Transportlīdzekļu uzlabojumi
MVDepthModules=Dziļuma moduļi
SpecificModules=Specifiski transportlīdzekļu uzlabojumi
GeneralTab=Vispārīgi
SeamothTab=Seamoth uzlabojumi
PrawnTab=Prawn Suit uzlabojumi
CyclopsTab=Cyclops uzlabojumi