EmptyHover=uten nytte
HeadLightsHover=Skift frontlys
FloodLightsHover=Skift flomlys
NavLightsHover=Skift navigasjonslys
InteriorLightsHover=Skift innvendig lys
DefaultColorHover=Gjenopprett standardfarger
PowerHover=Skift strøm
AutoPilotHover=Åpne Auto-Pilot (å gjøre)
OpenStorage=Åpne lagring
VehicleBattery=Kjøretøybatteri
AutoPilotBattery=Auto-Pilot-batteri
EnterVehicle=Enter kjøretøy
ExitVehicle=Forlat kjøretøy
Vehicle=Kjøretøy
StartPiloting=Start styring
TooSteep=Vinkelen er for bratt.\nFor automatisk nivellering, dobbelttrykk 
TooFast=Farten er for høy.\nFor automatisk bremsing, dobbelttrykk 
Depth1FriendlyString=Kjøretøydybdemodul MK1
Depth1Description=Øker trykkdybden noe. Ikke stabling.
Depth2FriendlyString=Kjøretøydybdemodul MK2
Depth2Description=Øker trykkdybden moderat. Ikke stabling.
Depth3FriendlyString=Kjøretøydybdemodul MK3
Depth3Description=Øker trykkdybden betydelig. Ikke stabling.
MainExterior=Hovedeksteriør
PrimaryAccent=Aksent 1
SecondaryAccent=Aksent 2
NameLabel=Navneetikett
MVModules=VF Kjøretøyoppgraderinger
MVDepthModules=Dybde moduler
SpecificModules=Spesifikke kjøretøyoppgraderinger
GeneralTab=Generelt
SeamothTab=Seamoth-oppgraderinger
PrawnTab=Prawn Suit-oppgraderinger
CyclopsTab=Cyclops-oppgraderinger