EmptyHover=geen nut
HeadLightsHover=Koplampen schakelen
FloodLightsHover=Schijnwerpers schakelen
NavLightsHover=Navigatielichten schakelen
InteriorLightsHover=Interieurverlichting schakelen
DefaultColorHover=Herstel standaardkleuren
PowerHover=Schakel stroom
AutoPilotHover=Auto-Piloot openen (te doen)
OpenStorage=Open opslag
VehicleBattery=Voertuigbatterij
AutoPilotBattery=Auto-Piloot Batterij
EnterVehicle=Voertuig betreden
ExitVehicle=Voertuig verlaten
Vehicle=Voertuig
StartPiloting=Begin met besturen
TooSteep=Hoek is te steil.\nVoor automatisch nivelleren, dubbel tikken 
TooFast=Snelheid is te hoog.\nVoor automatisch remmen, dubbel tikken 
Depth1FriendlyString=Voertuig Dieptemodule MK1
Depth1Description=Verhoogt de drukdiepte enigszins. Stapelt niet.
Depth2FriendlyString=Voertuig Dieptemodule MK2
Depth2Description=Verhoogt de drukdiepte gematigd. Stapelt niet.
Depth3FriendlyString=Voertuig Dieptemodule MK3
Depth3Description=Verhoogt de drukdiepte aanzienlijk. Stapelt niet.
MainExterior=Hoofdexterieur
PrimaryAccent=Accent 1
SecondaryAccent=Accent 2
NameLabel=Naamlabel
MVModules=VF Voertuigupgrades
MVDepthModules=Dieptemodules
SpecificModules=Specifieke voertuigupgrades
GeneralTab=Algemeen
SeamothTab=Seamoth-upgrades
PrawnTab=Prawn Suit-upgrades
CyclopsTab=Cyclops-upgrades