EmptyHover=bez użyteczności
HeadLightsHover=Przełącz światła przednie
FloodLightsHover=Przełącz światła przeciwmgielne
NavLightsHover=Przełącz światła nawigacyjne
InteriorLightsHover=Przełącz oświetlenie wnętrza
DefaultColorHover=Przywróć domyślne kolory
PowerHover=Przełącz zasilanie
AutoPilotHover=Otwórz Auto-Pilot (do zrobienia)
OpenStorage=Otwórz schowek
VehicleBattery=Bateria pojazdu
AutoPilotBattery=Bateria Auto-Pilota
EnterVehicle=Wejdź do pojazdu
ExitVehicle=Wyjdź z pojazdu
Vehicle=Pojazd
StartPiloting=Rozpocznij pilotowanie
TooSteep=Kąt zbyt stromy.\nAby automatycznie wyrównać, dwukrotnie dotknij 
TooFast=Prędkość zbyt duża.\nAby automatycznie wyhamować, dwukrotnie dotknij 
Depth1FriendlyString=Moduł głębokości pojazdu MK1
Depth1Description=Niewielkie zwiększenie głębokości. Nie łączy się.
Depth2FriendlyString=Moduł głębokości pojazdu MK2
Depth2Description=Umiarkowane zwiększenie głębokości. Nie łączy się.
Depth3FriendlyString=Moduł głębokości pojazdu MK3
Depth3Description=Znaczne zwiększenie głębokości. Nie łączy się.
MainExterior=Główna powierzchnia zewnętrzna
PrimaryAccent=Akcent 1
SecondaryAccent=Akcent 2
NameLabel=Etykieta z nazwą
MVModules=VF Ulepszenia pojazdów
MVDepthModules=Moduły głębokości
SpecificModules=Specyficzne ulepszenia pojazdów
GeneralTab=Ogólne
SeamothTab=Ulepszenia Seamoth
PrawnTab=Ulepszenia Prawn Suit
CyclopsTab=Ulepszenia Cyclops