EmptyHover=sem utilidade
HeadLightsHover=Alternar faróis
FloodLightsHover=Alternar luzes de inundação
NavLightsHover=Alternar luzes de navegação
InteriorLightsHover=Alternar luzes interiores
DefaultColorHover=Reverter para cores padrão
PowerHover=Alternar energia
AutoPilotHover=Abrir Auto-Piloto (a fazer)
OpenStorage=Abrir armazenamento
VehicleBattery=Bateria do veículo
AutoPilotBattery=Bateria do Auto-Piloto
EnterVehicle=Entrar no veículo
ExitVehicle=Sair do veículo
Vehicle=Veículo
StartPiloting=Iniciar pilotagem
TooSteep=Ângulo muito inclinado.\nPara nivelar automaticamente, toque duas vezes 
TooFast=Velocidade muito alta.\nPara travar automaticamente, toque duas vezes 
Depth1FriendlyString=Módulo de Profundidade do Veículo MK1
Depth1Description=Aumenta levemente a profundidade. Não acumula.
Depth2FriendlyString=Módulo de Profundidade do Veículo MK2
Depth2Description=Aumenta moderadamente a profundidade. Não acumula.
Depth3FriendlyString=Módulo de Profundidade do Veículo MK3
Depth3Description=Aumenta significativamente a profundidade. Não acumula.
MainExterior=Exterior principal
PrimaryAccent=Realce 1
SecondaryAccent=Realce 2
NameLabel=Etiqueta de nome
MVModules=Melhorias de Veículos VF
MVDepthModules=Módulos de Profundidade
SpecificModules=Melhorias Específicas de Veículos
GeneralTab=Geral
SeamothTab=Melhorias do Seamoth
PrawnTab=Melhorias do Prawn Suit
CyclopsTab=Melhorias do Cyclops