EmptyHover=fără folos
HeadLightsHover=Comută faruri
FloodLightsHover=Comută lumini de drum
NavLightsHover=Comută lumini de navigație
InteriorLightsHover=Comută lumini interioare
DefaultColorHover=Revino la culorile implicite
PowerHover=Comută alimentare
AutoPilotHover=Deschide Auto-Pilot (de făcut)
OpenStorage=Deschide depozit
VehicleBattery=Baterie vehicul
AutoPilotBattery=Baterie Auto-Pilot
EnterVehicle=Intră în vehicul
ExitVehicle=Ieși din vehicul
Vehicle=Vehicul
StartPiloting=Pornește pilotarea
TooSteep=Unghi prea înclinat.\nPentru nivelare automată, atinge de două ori 
TooFast=Viteză prea mare.\nPentru frânare automată, atinge de două ori 
Depth1FriendlyString=Modul adâncime vehicul MK1
Depth1Description=Creste adâncimea de presiune puțin. Nu se cumulează.
Depth2FriendlyString=Modul adâncime vehicul MK2
Depth2Description=Creste adâncimea de presiune moderat. Nu se cumulează.
Depth3FriendlyString=Modul adâncime vehicul MK3
Depth3Description=Creste adâncimea de presiune considerabil. Nu se cumulează.
MainExterior=Exterior principal
PrimaryAccent=Accent 1
SecondaryAccent=Accent 2
NameLabel=Etichetă nume
MVModules=Upgrade-uri de vehicule VF
MVDepthModules=Module de adâncime
SpecificModules=Upgrade-uri specifice pentru vehicule
GeneralTab=General
SeamothTab=Upgrade-uri Seamoth
PrawnTab=Upgrade-uri Prawn Suit
CyclopsTab=Upgrade-uri Cyclops