EmptyHover=бесполезно
HeadLightsHover=Переключить фары
FloodLightsHover=Переключить прожекторы
NavLightsHover=Переключить навигационные огни
InteriorLightsHover=Переключить внутреннее освещение
DefaultColorHover=Восстановить цвета по умолчанию
PowerHover=Переключить питание
AutoPilotHover=Открыть Авто-Пилот (в разработке)
OpenStorage=Открыть хранилище
VehicleBattery=Аккумулятор транспортного средства
AutoPilotBattery=Аккумулятор Авто-Пилота
EnterVehicle=Войти в транспортное средство
ExitVehicle=Выйти из транспортного средства
Vehicle=Транспортное средство
StartPiloting=Начать управление
TooSteep=Угол слишком крутой.\nДля выравнивания, двойной тап 
TooFast=Скорость слишком велика.\nДля торможения, двойной тап 
Depth1FriendlyString=Модуль глубины ТС МК1
Depth1Description=Слегка увеличивает предельную глубину. Не складывается.
Depth2FriendlyString=Модуль глубины ТС МК2
Depth2Description=Умеренно увеличивает предельную глубину. Не складывается.
Depth3FriendlyString=Модуль глубины ТС МК3
Depth3Description=Значительно увеличивает предельную глубину. Не складывается.
MainExterior=Основной экстерьер
PrimaryAccent=Акцент 1
SecondaryAccent=Акцент 2
NameLabel=Ярлык имени
MVModules=VF Улучшения транспорта
MVDepthModules=Модули глубины
SpecificModules=Специфические улучшения транспорта
GeneralTab=Общее
SeamothTab=Улучшения Seamoth
PrawnTab=Улучшения Prawn Suit
CyclopsTab=Улучшения Cyclops