EmptyHover=bez úžitku
HeadLightsHover=Prepnúť svetlomety
FloodLightsHover=Prepnúť reflektory
NavLightsHover=Prepnúť navigačné svetlá
InteriorLightsHover=Prepnúť vnútorné osvetlenie
DefaultColorHover=Obnoviť predvolené farby
PowerHover=Prepnúť napájanie
AutoPilotHover=Otvoriť Auto-Pilota (treba urobiť)
OpenStorage=Otvoriť úložisko
VehicleBattery=Batéria vozidla
AutoPilotBattery=Batéria Auto-Pilota
EnterVehicle=Nastúpiť do vozidla
ExitVehicle=Vystúpiť z vozidla
Vehicle=Vozidlo
StartPiloting=Začať pilotovanie
TooSteep=Uhol je príliš strmý.\nPre zarovnanie, dvojklik 
TooFast=Rýchlosť je príliš veľká.\nPre brzdenie, dvojklik 
Depth1FriendlyString=Modul hĺbky vozidla MK1
Depth1Description=Zväčší tlakovú hĺbku mierne. Neakumuluje.
Depth2FriendlyString=Modul hĺbky vozidla MK2
Depth2Description=Zväčší tlakovú hĺbku stredne. Neakumuluje.
Depth3FriendlyString=Modul hĺbky vozidla MK3
Depth3Description=Zväčší tlakovú hĺbku výrazne. Neakumuluje.
MainExterior=Hlavný exteriér
PrimaryAccent=Accent 1
SecondaryAccent=Accent 2
NameLabel=Menovka
MVModules=VF Vylepšenia vozidiel
MVDepthModules=Moduly hĺbky
SpecificModules=Špecifické vylepšenia vozidiel
GeneralTab=Všeobecné
SeamothTab=Vylepšenia pre Seamoth
PrawnTab=Vylepšenia pre Prawn Suit
CyclopsTab=Vylepšenia pre Cyclops