EmptyHover=без користи
HeadLightsHover=Укључи/искључи фарове
FloodLightsHover=Укључи/искључи рефлекторе
NavLightsHover=Укључи/искључи навигациона светла
InteriorLightsHover=Укључи/искључи унутрашња светла
DefaultColorHover=Врати на подразумеване боје
PowerHover=Укључи/искључи напајање
AutoPilotHover=Отвори аутопилот (треба урадити)
OpenStorage=Отвори складиште
VehicleBattery=Батерија возила
AutoPilotBattery=Батерија аутопилота
EnterVehicle=Уђи у возило
ExitVehicle=Изађи из возила
Vehicle=Возило
StartPiloting=Започни пилотирање
TooSteep=Угао је превелик.\nЗа аутоматско нивелирање, двоструко додирни 
TooFast=Брзина је превелика.\nЗа аутоматско кочење, двоструко додирни 
Depth1FriendlyString=Модул дубине возила МК1
Depth1Description=Мало повећава дубину. Не се гомилају.
Depth2FriendlyString=Модул дубине возила МК2
Depth2Description=Умерено повећава дубину. Не се гомилају.
Depth3FriendlyString=Модул дубине возила МК3
Depth3Description=Значајно повећава дубину. Не се гомилају.
MainExterior=Главни екстеријер
PrimaryAccent=Акценат 1
SecondaryAccent=Акценат 2
NameLabel=Ознака имена
MVModules=VF Унапређења возила
MVDepthModules=Модули дубине
SpecificModules=Специфична унапређења возила
GeneralTab=Опште
SeamothTab=Унапређења за Seamoth
PrawnTab=Унапређења за Prawn Suit
CyclopsTab=Унапређења за Cyclops