EmptyHover=utan användning
HeadLightsHover=Växla strålkastare
FloodLightsHover=Växla strålkastare
NavLightsHover=Växla navigationsljus
InteriorLightsHover=Växla interiörbelysning
DefaultColorHover=Återställ till standardfärger
PowerHover=Växla ström
AutoPilotHover=Öppna autopilot (att göra)
OpenStorage=Öppna förvaring
VehicleBattery=Fordonets batteri
AutoPilotBattery=Autopilotbatteri
EnterVehicle=Gå in i fordonet
ExitVehicle=Lämna fordonet
Vehicle=Fordon
StartPiloting=Börja styra
TooSteep=Vinkeln är för brant.\nFör automatisk nivå, dubbelklicka 
TooFast=Hastigheten är för hög.\nFör automatisk bromsning, dubbelklicka 
Depth1FriendlyString=Fordonets djupmodul MK1
Depth1Description=Ökar krossdjupet marginellt. Staplas inte.
Depth2FriendlyString=Fordonets djupmodul MK2
Depth2Description=Ökar krossdjupet måttligt. Staplas inte.
Depth3FriendlyString=Fordonets djupmodul MK3
Depth3Description=Ökar krossdjupet avsevärt. Staplas inte.
MainExterior=Huvudexteriör
PrimaryAccent=Akcent 1
SecondaryAccent=Akcent 2
NameLabel=Namnetikett
MVModules=VF Fordonsuppgraderingar
MVDepthModules=Djupmoduler
SpecificModules=Specifika fordonsuppgraderingar
GeneralTab=Allmänt
SeamothTab=Seamoth-uppgraderingar
PrawnTab=Prawn Suit-uppgraderingar
CyclopsTab=Cyclops-uppgraderingar