EmptyHover=ไร้ประโยชน์
HeadLightsHover=สลับไฟหน้า
FloodLightsHover=สลับไฟที่นำทาง
NavLightsHover=สลับไฟเส้นทาง
InteriorLightsHover=สลับไฟภายใน
DefaultColorHover=กลับสู่สีเริ่มต้น
PowerHover=สลับไฟ
AutoPilotHover=เปิด Auto-Pilot (ควรทำ)
OpenStorage=เปิดพื้นที่เก็บของ
VehicleBattery=แบตเตอรี่ยานพาหนะ
AutoPilotBattery=แบตเตอรี่ Auto-Pilot
EnterVehicle=เข้ายานพาหนะ
ExitVehicle=ออกจากยานพาหนะ
Vehicle=ยานพาหนะ
StartPiloting=เริ่มการควบคุม
TooSteep=มุมชันมากเกินไป\nเพื่อปรับระดับอัตโนมัติ, ดับเบิลแตะ 
TooFast=ความเร็วมากเกินไป\nเพื่อเบรกอัตโนมัติ, ดับเบิลแตะ 
Depth1FriendlyString=โมดูลความลึกยานพาหนะ MK1
Depth1Description=เพิ่มความลึกปรับความกดน้อย ไม่สามารถซ้อนกัน
Depth2FriendlyString=โมดูลความลึกยานพาหนะ MK2
Depth2Description=เพิ่มความลึกปรับความกดปานกลาง ไม่สามารถซ้อนกัน
Depth3FriendlyString=โมดูลความลึกยานพาหนะ MK3
Depth3Description=เพิ่มความลึกปรับความกดมาก ไม่สามารถซ้อนกัน
MainExterior=ส่วนนอกหลัก
PrimaryAccent=สีเน้น 1
SecondaryAccent=สีเน้น 2
NameLabel=ป้ายชื่อ
MVModules=การอัปเกรดยานพาหนะ VF
MVDepthModules=โมดูลความลึก
SpecificModules=การอัปเกรดเฉพาะของยานพาหนะ
GeneralTab=ทั่วไป
SeamothTab=การอัปเกรด Seamoth
PrawnTab=การอัปเกรด Prawn Suit
CyclopsTab=การอัปเกรด Cyclops