EmptyHover=faydasız
HeadLightsHover=Farları Değiştir
FloodLightsHover=Flaşörleri Değiştir
NavLightsHover=Navigasyon Işıklarını Değiştir
InteriorLightsHover=İç Aydınlatmayı Değiştir
DefaultColorHover=Varsayılan Renklere Dön
PowerHover=Güç Değiştir
AutoPilotHover=Oto-Pilot Aç (yapılacak)
OpenStorage=Depolama Aç
VehicleBattery=Araç Bataryası
AutoPilotBattery=Oto-Pilot Bataryası
EnterVehicle=Araç'a Gir
ExitVehicle=Araç'tan Çık
Vehicle=Araç
StartPiloting=Pilotluğa Başla
TooSteep=Açı çok dik.\nOtomatik dengeleme için çift dokun 
TooFast=Hız çok yüksek.\nOtomatik frenleme için çift dokun 
Depth1FriendlyString=Araç Derinlik Modülü MK1
Depth1Description=Basma Derinliği Az Artırır. Üst üste binmez.
Depth2FriendlyString=Araç Derinlik Modülü MK2
Depth2Description=Basma Derinliği Orta Artırır. Üst üste binmez.
Depth3FriendlyString=Araç Derinlik Modülü MK3
Depth3Description=Basma Derinliği Büyük Artırır. Üst üste binmez.
MainExterior=Ana Dış Kısım
PrimaryAccent=Vurgu 1
SecondaryAccent=Vurgu 2
NameLabel=İsim Etiketi
MVModules=VF Araç Yükseltmeleri
MVDepthModules=Derinlik Modülleri
SpecificModules=Özel Araç Yükseltmeleri
GeneralTab=Genel
SeamothTab=Seamoth Yükseltmeleri
PrawnTab=Prawn Suit Yükseltmeleri
CyclopsTab=Cyclops Yükseltmeleri