EmptyHover=без користі
HeadLightsHover=Перемкнути фари
FloodLightsHover=Перемкнути прожектори
NavLightsHover=Перемкнути навігаційні вогні
InteriorLightsHover=Перемкнути внутрішнє освітлення
DefaultColorHover=Повернути стандартні кольори
PowerHover=Перемкнути живлення
AutoPilotHover=Відкрити Авто-Пілот (в роботі)
OpenStorage=Відкрити сховище
VehicleBattery=Акумулятор транспортного засобу
AutoPilotBattery=Акумулятор авто-пілота
EnterVehicle=Увійти в транспортний засіб
ExitVehicle=Вийти з транспортного засобу
Vehicle=Транспортний засіб
StartPiloting=Почати керування
TooSteep=Кут занадто крутий.\nДля авто-вирівнювання, подвійний натиск 
TooFast=Швидкість занадто велика.\nДля авто-гальма, подвійний натиск 
Depth1FriendlyString=Модуль глибини транспортного засобу MK1
Depth1Description=Помірно збільшує глибину занурення. Не сумується.
Depth2FriendlyString=Модуль глибини транспортного засобу MK2
Depth2Description=Модеративно збільшує глибину занурення. Не сумується.
Depth3FriendlyString=Модуль глибини транспортного засобу MK3
Depth3Description=Суттєво збільшує глибину занурення. Не сумується.
MainExterior=Основний зовнішній вигляд
PrimaryAccent=Акцент 1
SecondaryAccent=Акцент 2
NameLabel=Наклейка з іменем
MVModules=VF Покращення транспорту
MVDepthModules=Модулі глибини
SpecificModules=Специфічні покращення транспортних засобів
GeneralTab=Загальне
SeamothTab=Покращення Seamoth
PrawnTab=Покращення Prawn Suit
CyclopsTab=Покращення Cyclops