EmptyHover=vô ích
HeadLightsHover=Bật/Tắt đèn pha
FloodLightsHover=Bật/Tắt đèn pha rộng
NavLightsHover=Bật/Tắt đèn định vị
InteriorLightsHover=Bật/Tắt đèn nội thất
DefaultColorHover=Phục hồi màu mặc định
PowerHover=Bật/Tắt nguồn
AutoPilotHover=Mở Auto-Pilot (cần làm)
OpenStorage=Mở kho chứa
VehicleBattery=Ắc quy xe
AutoPilotBattery=Ắc quy Auto-Pilot
EnterVehicle=Vào xe
ExitVehicle=Rời xe
Vehicle=Xe
StartPiloting=Bắt đầu điều khiển
TooSteep=Góc quá dốc.\nĐể tự động cân bằng, nhấn đúp 
TooFast=Tốc độ quá nhanh.\nĐể tự động phanh, nhấn đúp 
Depth1FriendlyString=Mô-đun sâu xe MK1
Depth1Description=Tăng độ sâu áp suất ít. Không chồng chất.
Depth2FriendlyString=Mô-đun sâu xe MK2
Depth2Description=Tăng độ sâu áp suất vừa. Không chồng chất.
Depth3FriendlyString=Mô-đun sâu xe MK3
Depth3Description=Tăng độ sâu áp suất nhiều. Không chồng chất.
MainExterior=Bề ngoài chính
PrimaryAccent=Điểm nhấn 1
SecondaryAccent=Điểm nhấn 2
NameLabel= Nhãn tên
MVModules=Nâng cấp Phương tiện VF
MVDepthModules=Mô-đun độ sâu
SpecificModules=Nâng cấp phương tiện cụ thể
GeneralTab=Chung
SeamothTab=Nâng cấp Seamoth
PrawnTab=Nâng cấp Prawn Suit
CyclopsTab=Nâng cấp Cyclops