EmptyHover=无用
HeadLightsHover=切换头灯
FloodLightsHover=切换泛光灯
NavLightsHover=切换导航灯
InteriorLightsHover=切换内部灯光
DefaultColorHover=恢复默认颜色
PowerHover=切换电源
AutoPilotHover=打开自动驾驶(待完成)
OpenStorage=打开储物箱
VehicleBattery=车辆电池
AutoPilotBattery=自动驾驶电池
EnterVehicle=进入车辆
ExitVehicle=退出车辆
Vehicle=车辆
StartPiloting=开始驾驶
TooSteep=角度太陡。\n要自动水平，双击 
TooFast=速度太快。\n要自动刹车，双击 
Depth1FriendlyString=车辆深度模块 MK1
Depth1Description=略微增加压力深度。不可叠加。
Depth2FriendlyString=车辆深度模块 MK2
Depth2Description=适度增加压力深度。不可叠加。
Depth3FriendlyString=车辆深度模块 MK3
Depth3Description=大幅增加压力深度。不可叠加。
MainExterior=主外观
PrimaryAccent=重点色彩 1
SecondaryAccent=重点色彩 2
NameLabel=名称标签
MVModules=VF 载具升级
MVDepthModules=深度模块
SpecificModules=特定载具升级
GeneralTab=通用
SeamothTab=Seamoth升级
PrawnTab=Prawn Suit升级
CyclopsTab=Cyclops升级