EmptyHover=無用
HeadLightsHover=切換頭燈
FloodLightsHover=切換泛光燈
NavLightsHover=切換導航燈
InteriorLightsHover=切換內部燈光
DefaultColorHover=恢復默認顏色
PowerHover=切換電源
AutoPilotHover=打開自動駕駛(待完成)
OpenStorage=打開儲物箱
VehicleBattery=車輛電池
AutoPilotBattery=自動駕駛電池
EnterVehicle=進入車輛
ExitVehicle=退出車輛
Vehicle=車輛
StartPiloting=開始駕駛
TooSteep=角度太陡。\n要自動水平，雙擊 
TooFast=速度太快。\n要自動剎車，雙擊 
Depth1FriendlyString=車輛深度模塊 MK1
Depth1Description=略微增加壓力深度。不可疊加。
Depth2FriendlyString=車輛深度模塊 MK2
Depth2Description=適度增加壓力深度。不可疊加。
Depth3FriendlyString=車輛深度模塊 MK3
Depth3Description=大幅增加壓力深度。不可疊加。
MainExterior=主外觀
PrimaryAccent=重點色彩 1
SecondaryAccent=重點色彩 2
NameLabel=名稱標籤
MVModules=VF 載具升級
MVDepthModules=深度模組
SpecificModules=特定載具升級
GeneralTab=一般
SeamothTab=Seamoth升級
PrawnTab=Prawn Suit升級
CyclopsTab=Cyclops升級